###########
#..#-----@#
#..#-$-$-##
#-----$-##-
#--#-$-##--
#--#--##---
#----##----
######-----
